[
  [
    "F4\nB5",
    "F5\nB5",
    "F6\nB5",
    "F7\nB5",
    "B1\nB5",
    "B3\nB5",
    "B2\nB5"
  ],
  [
    "F4\nB4",
    "F5\nB4",
    "F6\nB4",
    "F7\nB4",
    "B1\nB4",
    "B3\nB4",
    "B2\nB4"
  ],
  [
    "F4\nE6",
    "F5\nE6",
    "F6\nE6",
    "F7\nE6",
    "B1\nE6",
    "B3\nE6",
    "B2\nE6",
    "B6\nE6"
  ],
  [
    "F4\nD7",
    "F5\nD7",
    "F6\nD7",
    "F7\nD7",
    "B1\nD7",
    "B3\nD7",
    "B2\nD7",
    "B6\nD7"
  ],
  [
    "F4\nC6",
    "F5\nC6",
    "F6\nC6",
    "F7\nC6",
    "B1\nC6",
    "B3\nC6",
    "B2\nC6",
    "B6\nC6"
  ]
]